;German language- file
;####################
;2014-July-05
;by BellaPatricia

;Global- Tab
lblGlobalStatus = Status
lblGlobalChangePosKey = Position/ Größe der Panels ändern
lblGlobalPluginDescription = Beschreibung:
lblGlobalDrawingMiliseconds = Millisekunden (ms)
lblGlobalDataMiliseconds = Millisekunden (ms)
lblGlobalDrawingRefresh = Neuzeichnen:
lblGlobalDataRefresh = Daten Interval:
lblGlobalFileName = Dateiname:
lblGlobalLanguage = Sprache:
btnGlobalSetPosition = Position anhand der Auflösung bestimmen
btnGlobalDonations = Spenden durch Paypal tätigen
chBxGlobalForegroundDraw = Panels nur anzeigen, wenn SC2 im Vordergrund ist
gbGlobalPublicInformation = Neuigkeiten
gbGlobalFileInformation = Datei- Informationen
gbGlobalUpdates = Updates
gbGlobalPlugins = Plug- Ins

;Basics (Remove Ai for Resources, Income, Apm, Army, partly Maphack)
lblRemoveAi = Entferne KI:
lblRemoveAllie = Entferne Alliierte:
lblRemoveNeutral = Entferne Neutrale:
lblRemoveLocalplayer = Entferne Dich:
lblRemoveClantag = Entferne Clantags:
lblFontName = Schriftart:
chBxDrawBackground = Zeichne Hintergrund
lblOpacityText = Sichtbarkeit:
gbBasicOptions = Allgemeine Panel- Optionen

;Maphack (Destination Line, Disable Dest. Line, Def. Color, Rem Vis. Area, Rem. Camera)
lblMaphackDestinationLine = Linie zum Ziel
gbMaphackBasics = Allgemeine Panel Optionen
chBxMaphackRemCamera = Entferne die Kamera
chBxMaphackRemVisionArea = Entferne den Sichtbarkeitsbereich
chBxMaphackColorDefensiveStructuresYellow = Verteidigungsanlagen gelb einfärben?
chBxMaphackDisableDestinationLine = Entferne die Linie zum Ziel
btnMapAddUnit = Einheit hinzufügen
gbMaphackColorUnits = Einheiten einfärben

;Chat- Input for all panels
gbChatInput = Chat- Eingabe
lblEnablePanel = Panel Ein-/ Ausschalten:
lblChangePosition = Panelposition ändern:
lblChangeSize = Panelgröße ändern:

;Keypresses (Hotkeys) to launch, resize and reposition all panels
gbLaunchPanels = Panels starten
lblHotkey1 = Hotkey 1:
lblHotkey2 = Hotkey 2:
lblHotkey3 = Hotkey 3:

;Panelinformation (PosX, PosY, Width, Height)
gbInformation = Informationen
lblPosX = Position X:
lblPosY = Position Y:
lblWidth = Breite:
lblHeight = Höhe:

;Unittab/ Prodtab - (Split buildings and special stuff)
gbUnittabBasics = Allgemeine Panel Optionen
gbUnittabShow = Anzeigen
gbProdtabShow = Anzeigen
gbUnitPicture = Bildgröße
gbProdPicture = Bildgröße
chBxProdTabShowUpgrades = Upgrades
chBxProdTabShowUnits = Einheiten
chBxProdTabShowBuildings = Gebäude
chBxUnitTabShowUnits = Einheiten
chBxUnitTabShowBuildings = Gebäude
lblSplitBuildings = Gebäude/ Einheiten aufteilen:
lblRemoveProdLine = Entferne Prod. Linie:
lblRemoveChronoboost = Entferne Chronoboost:
lblRemoveSpellcounter = Entferne Fähigkeitenzähler:
lblUnitPictureSize = Größe (px):
lblUnitPicturePreview = Vorschau:
lblProdPictureSize = Größe (px):
lblProdPicturePreview = Vorschau:

;Various- tab
gbPersonalOverlay = Persönliches Overlay
gbClock = Uhr
gbApm = Apm
chBxClock = Uhr Anzeigen
chBxApm = Apm Anzeigen
chBxApmAlert = Apm Warnung

;Worker- Automation
gbAutoWorker = Automatisierte Arbeiter
lblAutoWorkerMaxWorkers = Maximum der Arbeiter im Spiel:
lblAutoWorkerMaynardingPuffer = Maynarding Puffer:
lblAutoWorkerMaxWorkersPewBase = Maximum der Arbeiter pro Basis:
lblAutoWorkerApmOver = Deaktivieren bei APM über:
lblAutoWorkerKeyProbe = Taste für Probe:
lblAutoWorkerKeyScv = Taste für Wbf:
lblAutoWorkerKeyOrbital = Taste für Orbital:
lblAutoWorkerBackupGroup = Taste für die Backup- Gruppe:
lblAutoWorkerKeyMainGroup = Taste für die Hauptgebäude:
lblAutoWorkerNextWorkerPercentage = Nächsten Arbeiter starten bei:
chBxAutomationEnableWorkerProduction = Arbeiterproduktion aktivieren
chBxDisableWhenWorkerIsSelected = Bei Arbeiter- Selektion deaktivieren
chBxDisableWhenSelecting = Bei Auswahl deaktivieren
chBxAutoUpgradeToOc = Automatisch zum OC upgraden
rdbRoundWorkerProduction = Rundenbasierte Produktion
rdbDirectWorkerProduction = Direkte Produktion

;[Bugs] - Tab
gbCreateThreadOnD3Scene = Post auf D3Scene erstellen
btnCreateNewPost = Öffne Thema